11111111111111111111
10P0000000000C000001
10000000000000000001
10000000000000000001
10000000000000000001
10000000000000E00001
10000000000000000001
11111111111111111111